00000001
00001001
01010000
00100001 // addu 10 8 9
00000001
01001011
01100000
00100001 // addu 12 10 11
00000001
10101010
01001000
00100011 // subu 9, 13, 10
10001101
01001101
00000000
00011000 // lw 13, 24(10)
10101101
00101101
00000000
00001100 // sw 13, 12(9)
11111111
11111111
11111111
11111111
10001100
00001110
00000000
00001110 // lw r14, 14(0)
10001101
11001111
00000000
00000101 // lw r15, 5(r14)
00000001
11101000
01011000
00100001 // addu r11 r15 r8
11111111
11111111
11111111
11111111
10001100
00001110
00000000
00001010 // lw r14 10(0)
10101100
00001110
00000000
01100100 // sw r14, 100(0)
11111111
11111111
11111111
11111111
00000001
00101010
01000000
00100001
00000001
00101010
01011000
00100011
00000001
00101011
01100000
00100011
00000001
00001010
01101000
00100001
00000001
10101100
01101000
00100011
00000001
10101101
01000000
00100001
10101101
10101000
00000000
00001010 // sw r8 10(r13)
00000001
00001101
01000000
00100011 // subu r8 r8 r13
10101101
00001000
00000000
00010100 // sw r8 20(r8)
00000000
00000000
00000000
00000000
00000000
00000000
00000000
00000000
00000000
00000000
00000000
00000000
00000000
00000000
00000000
00000000
00000001
10001101
01011000
00100001 // addu r11 r12 r13
00000001
01101101
01100000
00100011 // subu r12 r11 r13
10101101
01101100
00000000
00010100 // sw r12 20(r11)
10101101
10001011
00000000
00111100 // sw r11 60(r12)
10001100
00001110
00000000
00001010 // lw r14 10(0)
00000001
10001110
01011000
00100001 // addu r12, r13, r14
10001100
00001110
00000000
00001010 // lw r14 10(0)
10101100
00001110
00000000
01100100 // sw r14, 100(0)
11111111
11111111
11111111
11111111
00000000
00000000
00000000
00000000
11111111
11111111
11111111
11111111
11111111
11111111
11111111
11111111 // 
10001100
00000001
00000000
00000000
10001100
00000010
00000000
00000100
10001100
00000011
00000000
00000000
10001100
00000100
00000000
00000100
10001100
00000101
00000000
00000000
00000000
00100010
00110000
00100001
00000000
00100010
00111000
00100011
10101100
00000001
00000000
00001000
11111111
11111111
11111111
11111111
